{
  "direction": 1,
  "map": [
    [{"h":1, "t":"b"},{"h":1, "t":"b"},{"h":1, "t":"b"},{"h":1, "t":"b"}, {"h":1, "t":"b"},{"h":1, "t":"b"},{"h":1, "t":"b"}],
    [{"h":1, "t":"b"},{"h":1, "t":"x"},{"h":2, "t":"b"},{"h":2, "t":"l"}, {"h":2, "t":"b"},{"h":2, "t":"l"},{"h":1, "t":"b"}],
    [{"h":1, "t":"b"},{"h":1, "t":"b"},{"h":1, "t":"b"},{"h":2, "t":"b"}, {"h":1, "t":"b"},{"h":2, "t":"b"},{"h":1, "t":"b"}],
    [{"h":1, "t":"b"},{"h":2, "t":"l"},{"h":2, "t":"b"},{"h":2, "t":"l"}, {"h":2, "t":"b"},{"h":2, "t":"l"},{"h":1, "t":"b"}],
    [{"h":1, "t":"b"},{"h":2, "t":"b"},{"h":1, "t":"b"},{"h":2, "t":"b"}, {"h":1, "t":"b"},{"h":2, "t":"b"},{"h":1, "t":"b"}],
    [{"h":1, "t":"b"},{"h":2, "t":"l"},{"h":2, "t":"b"},{"h":2, "t":"l"}, {"h":2, "t":"b"},{"h":2, "t":"l"},{"h":1, "t":"b"}],
    [{"h":1, "t":"b"},{"h":1, "t":"b"},{"h":1, "t":"b"},{"h":1, "t":"b"}, {"h":1, "t":"b"},{"h":1, "t":"b"},{"h":1, "t":"b"}]
  ],
  "medals": {
    "gold": 7,
    "silver": 1,
    "bronze": 1
  }
}