{
  "direction": 0,
  "map": [
    [{"h":2, "t":"b"}, {"h":1, "t":"b"},{"h":1, "t":"b"},{"h":1, "t":"b"},{"h":1, "t":"b"}, {"h":1, "t":"b"},{"h":1, "t":"b"},{"h":1, "t":"b"},{"h":2, "t":"b"}],
    [{"h":2, "t":"b"}, {"h":1, "t":"b"},{"h":1, "t":"b"},{"h":1, "t":"b"},{"h":1, "t":"b"}, {"h":1, "t":"b"},{"h":1, "t":"b"},{"h":1, "t":"b"},{"h":2, "t":"b"}],
    [{"h":2, "t":"b"}, {"h":1, "t":"b"},{"h":1, "t":"x"},{"h":1, "t":"b"},{"h":1, "t":"b"}, {"h":1, "t":"b"},{"h":1, "t":"l"},{"h":1, "t":"b"},{"h":2, "t":"b"}],
    [{"h":2, "t":"b"}, {"h":1, "t":"b"},{"h":1, "t":"b"},{"h":1, "t":"b"},{"h":1, "t":"b"}, {"h":1, "t":"b"},{"h":1, "t":"b"},{"h":1, "t":"b"},{"h":2, "t":"b"}],
    [{"h":2, "t":"b"}, {"h":1, "t":"b"},{"h":1, "t":"b"},{"h":1, "t":"b"},{"h":1, "t":"b"}, {"h":1, "t":"b"},{"h":1, "t":"b"},{"h":1, "t":"b"},{"h":2, "t":"b"}],
    [{"h":2, "t":"b"}, {"h":1, "t":"b"},{"h":1, "t":"b"},{"h":1, "t":"b"},{"h":1, "t":"b"}, {"h":1, "t":"b"},{"h":1, "t":"b"},{"h":1, "t":"b"},{"h":2, "t":"b"}],
    [{"h":2, "t":"b"}, {"h":1, "t":"b"},{"h":1, "t":"l"},{"h":1, "t":"b"},{"h":1, "t":"b"}, {"h":1, "t":"b"},{"h":1, "t":"l"},{"h":1, "t":"b"},{"h":2, "t":"b"}],
    [{"h":2, "t":"b"}, {"h":1, "t":"b"},{"h":1, "t":"b"},{"h":1, "t":"b"},{"h":1, "t":"b"}, {"h":1, "t":"b"},{"h":1, "t":"b"},{"h":1, "t":"b"},{"h":2, "t":"b"}]
  ],
  "medals": {
    "gold": 5,
    "silver": 7,
    "bronze": 11
  }
}