{
  "direction": 0,
  "map": [
    [{"h":4, "t":"b"}, {"h":1, "t":"b"},{"h":1, "t":"b"},{"h":1, "t":"b"},{"h":1, "t":"b"}, {"h":1, "t":"b"},{"h":1, "t":"b"},{"h":1, "t":"b"},{"h":4, "t":"b"}],
    [{"h":3, "t":"b"}, {"h":1, "t":"b"},{"h":1, "t":"b"},{"h":1, "t":"b"},{"h":1, "t":"b"}, {"h":1, "t":"b"},{"h":1, "t":"b"},{"h":1, "t":"b"},{"h":3, "t":"b"}],
    [{"h":2, "t":"b"}, {"h":1, "t":"b"},{"h":1, "t":"b"},{"h":1, "t":"b"},{"h":1, "t":"x"}, {"h":1, "t":"b"},{"h":1, "t":"b"},{"h":1, "t":"b"},{"h":2, "t":"b"}],
    [{"h":2, "t":"b"}, {"h":1, "t":"b"},{"h":1, "t":"b"},{"h":1, "t":"b"},{"h":1, "t":"b"}, {"h":1, "t":"b"},{"h":1, "t":"b"},{"h":1, "t":"b"},{"h":2, "t":"b"}],
    [{"h":2, "t":"b"}, {"h":1, "t":"b"},{"h":1, "t":"b"},{"h":1, "t":"b"},{"h":3, "t":"b"}, {"h":1, "t":"b"},{"h":1, "t":"b"},{"h":1, "t":"b"},{"h":2, "t":"b"}],
    [{"h":2, "t":"b"}, {"h":1, "t":"b"},{"h":1, "t":"b"},{"h":1, "t":"b"},{"h":1, "t":"b"}, {"h":1, "t":"b"},{"h":1, "t":"b"},{"h":1, "t":"b"},{"h":2, "t":"b"}],
    [{"h":3, "t":"b"}, {"h":1, "t":"b"},{"h":1, "t":"b"},{"h":1, "t":"b"},{"h":1, "t":"l"}, {"h":1, "t":"b"},{"h":1, "t":"b"},{"h":1, "t":"b"},{"h":3, "t":"b"}],
    [{"h":4, "t":"b"}, {"h":1, "t":"b"},{"h":1, "t":"b"},{"h":1, "t":"b"},{"h":1, "t":"b"}, {"h":1, "t":"b"},{"h":1, "t":"b"},{"h":1, "t":"b"},{"h":4, "t":"b"}]
  ],
  "medals": {
    "gold": 6,
    "silver": 8,
    "bronze": 11
  }
}