{
  "direction": 1,
  "map": [
    [{"h":1, "t":"b"}, {"h":1, "t":"b"},{"h":1, "t":"b"},{"h":1, "t":"b"},{"h":1, "t":"b"}, {"h":1, "t":"b"},{"h":1, "t":"b"}],
    [{"h":1, "t":"b"}, {"h":1, "t":"x"},{"h":1, "t":"b"},{"h":2, "t":"b"},{"h":3, "t":"b"}, {"h":3, "t":"b"},{"h":1, "t":"b"}],
    [{"h":1, "t":"b"}, {"h":1, "t":"b"},{"h":1, "t":"b"},{"h":1, "t":"b"},{"h":1, "t":"b"}, {"h":3, "t":"b"},{"h":1, "t":"b"}],
    [{"h":1, "t":"b"}, {"h":1, "t":"b"},{"h":1, "t":"b"},{"h":1, "t":"b"},{"h":1, "t":"b"}, {"h":3, "t":"b"},{"h":1, "t":"b"}],
    [{"h":1, "t":"b"}, {"h":1, "t":"b"},{"h":1, "t":"b"},{"h":1, "t":"b"},{"h":1, "t":"b"}, {"h":3, "t":"b"},{"h":1, "t":"b"}],
    [{"h":1, "t":"b"}, {"h":1, "t":"b"},{"h":1, "t":"b"},{"h":1, "t":"b"},{"h":1, "t":"b"}, {"h":3, "t":"b"},{"h":1, "t":"b"}],
    [{"h":1, "t":"b"}, {"h":1, "t":"b"},{"h":1, "t":"b"},{"h":1, "t":"b"},{"h":1, "t":"b"}, {"h":3, "t":"l"},{"h":1, "t":"b"}]
  ],
  "medals": {
    "gold": 7,
    "silver": 8,
    "bronze": 11
  }
}