{
  "direction": 0,
  "map": [
    [{"h":1, "t":"b"}, {"h":1, "t":"b"},{"h":1, "t":"b"},{"h":1, "t":"b"},{"h":1, "t":"b"}, {"h":1, "t":"b"},{"h":1, "t":"b"},{"h":1, "t":"b"}],
    [{"h":1, "t":"b"}, {"h":1, "t":"b"},{"h":1, "t":"b"},{"h":1, "t":"b"},{"h":1, "t":"b"}, {"h":1, "t":"b"},{"h":1, "t":"b"},{"h":1, "t":"b"}],
    [{"h":1, "t":"b"}, {"h":1, "t":"b"},{"h":1, "t":"b"},{"h":1, "t":"b"},{"h":1, "t":"b"}, {"h":1, "t":"b"},{"h":1, "t":"b"},{"h":1, "t":"b"}],
    [{"h":1, "t":"b"}, {"h":1, "t":"b"},{"h":1, "t":"x"},{"h":1, "t":"b"},{"h":1, "t":"b"}, {"h":1, "t":"b"},{"h":6, "t":"l"},{"h":1, "t":"b"}],
    [{"h":1, "t":"b"}, {"h":1, "t":"b"},{"h":2, "t":"b"},{"h":1, "t":"b"},{"h":1, "t":"b"}, {"h":1, "t":"b"},{"h":5, "t":"b"},{"h":1, "t":"b"}],
    [{"h":1, "t":"b"}, {"h":1, "t":"b"},{"h":3, "t":"b"},{"h":1, "t":"b"},{"h":1, "t":"b"}, {"h":1, "t":"b"},{"h":4, "t":"b"},{"h":1, "t":"b"}],
    [{"h":1, "t":"b"}, {"h":1, "t":"b"},{"h":3, "t":"b"},{"h":3, "t":"b"},{"h":3, "t":"b"}, {"h":3, "t":"b"},{"h":3, "t":"b"},{"h":1, "t":"b"}],
    [{"h":1, "t":"b"}, {"h":1, "t":"b"},{"h":1, "t":"b"},{"h":1, "t":"b"},{"h":1, "t":"b"}, {"h":1, "t":"b"},{"h":1, "t":"b"},{"h":1, "t":"b"}]
  ],
  "medals": {
    "gold": 7,
    "silver": 10,
    "bronze": 13
  }
}