{
  "direction": 0,
  "map": [
    [{"h":3, "t":"b"},{"h":3, "t":"b"},{"h":2, "t":"b"},{"h":1, "t":"b"},{"h":1, "t":"x"}, {"h":1, "t":"b"},{"h":2, "t":"b"},{"h":3, "t":"b"},{"h":3, "t":"b"}],
    [{"h":3, "t":"b"},{"h":1, "t":"b"},{"h":1, "t":"b"},{"h":1, "t":"b"},{"h":2, "t":"l"}, {"h":1, "t":"b"},{"h":1, "t":"b"},{"h":1, "t":"b"},{"h":3, "t":"b"}],
    [{"h":2, "t":"b"},{"h":1, "t":"b"},{"h":1, "t":"b"},{"h":1, "t":"b"},{"h":3, "t":"l"}, {"h":1, "t":"b"},{"h":1, "t":"b"},{"h":1, "t":"b"},{"h":2, "t":"b"}],
    [{"h":2, "t":"b"},{"h":1, "t":"b"},{"h":1, "t":"b"},{"h":1, "t":"b"},{"h":4, "t":"l"}, {"h":1, "t":"b"},{"h":1, "t":"b"},{"h":1, "t":"b"},{"h":2, "t":"b"}],
    [{"h":2, "t":"b"},{"h":1, "t":"b"},{"h":1, "t":"b"},{"h":1, "t":"b"},{"h":1, "t":"b"}, {"h":1, "t":"b"},{"h":1, "t":"b"},{"h":1, "t":"b"},{"h":2, "t":"b"}],
    [{"h":2, "t":"b"},{"h":1, "t":"b"},{"h":1, "t":"b"},{"h":1, "t":"b"},{"h":2, "t":"l"}, {"h":1, "t":"b"},{"h":1, "t":"b"},{"h":1, "t":"b"},{"h":2, "t":"b"}],
    [{"h":2, "t":"b"},{"h":1, "t":"b"},{"h":1, "t":"b"},{"h":1, "t":"b"},{"h":3, "t":"l"}, {"h":1, "t":"b"},{"h":1, "t":"b"},{"h":1, "t":"b"},{"h":2, "t":"b"}],
    [{"h":2, "t":"b"},{"h":1, "t":"b"},{"h":1, "t":"b"},{"h":1, "t":"b"},{"h":4, "t":"l"}, {"h":1, "t":"b"},{"h":1, "t":"b"},{"h":1, "t":"b"},{"h":2, "t":"b"}]
  ],
  "medals": {
    "gold": 3,
    "silver": 7,
    "bronze": 13
  }
}