[
  {
    "direction": 0,
    "position": {"x": 4, "y": 5},
    "map": [
      [{"h":2, "t":"b"}, {"h":1, "t":"b"},{"h":1, "t":"b"},{"h":1, "t":"b"},{"h":1, "t":"b"}, {"h":1, "t":"b"},{"h":1, "t":"b"},{"h":1, "t":"b"},{"h":2, "t":"b"}],
      [{"h":2, "t":"b"}, {"h":1, "t":"b"},{"h":1, "t":"b"},{"h":1, "t":"b"},{"h":1, "t":"b"}, {"h":1, "t":"b"},{"h":1, "t":"b"},{"h":1, "t":"b"},{"h":2, "t":"b"}],
      [{"h":2, "t":"b"}, {"h":1, "t":"b"},{"h":1, "t":"b"},{"h":1, "t":"b"},{"h":1, "t":"b"}, {"h":1, "t":"b"},{"h":1, "t":"b"},{"h":1, "t":"b"},{"h":2, "t":"b"}],
      [{"h":2, "t":"b"}, {"h":1, "t":"b"},{"h":1, "t":"b"},{"h":1, "t":"b"},{"h":1, "t":"b"}, {"h":1, "t":"b"},{"h":1, "t":"b"},{"h":1, "t":"b"},{"h":2, "t":"b"}],
      [{"h":2, "t":"b"}, {"h":1, "t":"b"},{"h":1, "t":"b"},{"h":1, "t":"b"},{"h":1, "t":"l"}, {"h":1, "t":"b"},{"h":1, "t":"b"},{"h":1, "t":"b"},{"h":2, "t":"b"}],
      [{"h":2, "t":"b"}, {"h":1, "t":"b"},{"h":1, "t":"b"},{"h":1, "t":"b"},{"h":1, "t":"b"}, {"h":1, "t":"b"},{"h":1, "t":"b"},{"h":1, "t":"b"},{"h":2, "t":"b"}],
      [{"h":2, "t":"b"}, {"h":1, "t":"b"},{"h":1, "t":"b"},{"h":1, "t":"b"},{"h":1, "t":"b"}, {"h":1, "t":"b"},{"h":1, "t":"b"},{"h":1, "t":"b"},{"h":2, "t":"b"}],
      [{"h":2, "t":"b"}, {"h":1, "t":"b"},{"h":1, "t":"b"},{"h":1, "t":"b"},{"h":1, "t":"b"}, {"h":1, "t":"b"},{"h":1, "t":"b"},{"h":1, "t":"b"},{"h":2, "t":"b"}]
    ],
    "medals": {
      "gold": 3,
      "silver": 4,
      "bronze": 5
    }
  },
  {
    "direction": 0,
    "position": {"x": 2, "y": 5},
    "map": [
      [{"h":2, "t":"b"}, {"h":1, "t":"b"},{"h":1, "t":"b"},{"h":1, "t":"b"},{"h":1, "t":"b"}, {"h":1, "t":"b"},{"h":1, "t":"b"},{"h":1, "t":"b"},{"h":2, "t":"b"}],
      [{"h":2, "t":"b"}, {"h":1, "t":"b"},{"h":1, "t":"b"},{"h":1, "t":"b"},{"h":1, "t":"b"}, {"h":1, "t":"b"},{"h":1, "t":"b"},{"h":1, "t":"b"},{"h":2, "t":"b"}],
      [{"h":2, "t":"b"}, {"h":1, "t":"b"},{"h":1, "t":"b"},{"h":1, "t":"b"},{"h":1, "t":"b"}, {"h":1, "t":"b"},{"h":1, "t":"l"},{"h":1, "t":"b"},{"h":2, "t":"b"}],
      [{"h":2, "t":"b"}, {"h":1, "t":"b"},{"h":1, "t":"b"},{"h":1, "t":"b"},{"h":1, "t":"b"}, {"h":1, "t":"b"},{"h":1, "t":"b"},{"h":1, "t":"b"},{"h":2, "t":"b"}],
      [{"h":2, "t":"b"}, {"h":1, "t":"b"},{"h":1, "t":"b"},{"h":1, "t":"b"},{"h":1, "t":"b"}, {"h":1, "t":"b"},{"h":1, "t":"b"},{"h":1, "t":"b"},{"h":2, "t":"b"}],
      [{"h":2, "t":"b"}, {"h":1, "t":"b"},{"h":1, "t":"b"},{"h":1, "t":"b"},{"h":1, "t":"b"}, {"h":1, "t":"b"},{"h":1, "t":"b"},{"h":1, "t":"b"},{"h":2, "t":"b"}],
      [{"h":2, "t":"b"}, {"h":1, "t":"b"},{"h":1, "t":"l"},{"h":1, "t":"b"},{"h":1, "t":"b"}, {"h":1, "t":"b"},{"h":1, "t":"l"},{"h":1, "t":"b"},{"h":2, "t":"b"}],
      [{"h":2, "t":"b"}, {"h":1, "t":"b"},{"h":1, "t":"b"},{"h":1, "t":"b"},{"h":1, "t":"b"}, {"h":1, "t":"b"},{"h":1, "t":"b"},{"h":1, "t":"b"},{"h":2, "t":"b"}]
    ],
    "medals": {
      "gold": 5,
      "silver": 7,
      "bronze": 11
    }
  },
  {
    "direction": 0,
    "position": {"x": 4, "y": 5},
    "map": [
      [{"h":4, "t":"b"}, {"h":1, "t":"b"},{"h":1, "t":"b"},{"h":1, "t":"b"},{"h":1, "t":"b"}, {"h":1, "t":"b"},{"h":1, "t":"b"},{"h":1, "t":"b"},{"h":4, "t":"b"}],
      [{"h":3, "t":"b"}, {"h":1, "t":"b"},{"h":1, "t":"b"},{"h":1, "t":"b"},{"h":1, "t":"b"}, {"h":1, "t":"b"},{"h":1, "t":"b"},{"h":1, "t":"b"},{"h":3, "t":"b"}],
      [{"h":2, "t":"b"}, {"h":1, "t":"b"},{"h":1, "t":"b"},{"h":1, "t":"b"},{"h":1, "t":"b"}, {"h":1, "t":"b"},{"h":1, "t":"b"},{"h":1, "t":"b"},{"h":2, "t":"b"}],
      [{"h":2, "t":"b"}, {"h":1, "t":"b"},{"h":1, "t":"b"},{"h":1, "t":"b"},{"h":1, "t":"b"}, {"h":1, "t":"b"},{"h":1, "t":"b"},{"h":1, "t":"b"},{"h":2, "t":"b"}],
      [{"h":2, "t":"b"}, {"h":1, "t":"b"},{"h":1, "t":"b"},{"h":1, "t":"b"},{"h":3, "t":"b"}, {"h":1, "t":"b"},{"h":1, "t":"b"},{"h":1, "t":"b"},{"h":2, "t":"b"}],
      [{"h":2, "t":"b"}, {"h":1, "t":"b"},{"h":1, "t":"b"},{"h":1, "t":"b"},{"h":1, "t":"b"}, {"h":1, "t":"b"},{"h":1, "t":"b"},{"h":1, "t":"b"},{"h":2, "t":"b"}],
      [{"h":3, "t":"b"}, {"h":1, "t":"b"},{"h":1, "t":"b"},{"h":1, "t":"b"},{"h":1, "t":"l"}, {"h":1, "t":"b"},{"h":1, "t":"b"},{"h":1, "t":"b"},{"h":3, "t":"b"}],
      [{"h":4, "t":"b"}, {"h":1, "t":"b"},{"h":1, "t":"b"},{"h":1, "t":"b"},{"h":1, "t":"b"}, {"h":1, "t":"b"},{"h":1, "t":"b"},{"h":1, "t":"b"},{"h":4, "t":"b"}]
    ],
    "medals": {
      "gold": 6,
      "silver": 8,
      "bronze": 11
    }
  },
  {
    "direction": 0,
    "position": {"x": 4, "y": 7},
    "map": [
      [{"h":1, "t":"b"}, {"h":1, "t":"b"},{"h":1, "t":"b"},{"h":1, "t":"b"},{"h":1, "t":"b"}, {"h":1, "t":"b"},{"h":1, "t":"b"},{"h":1, "t":"b"},{"h":1, "t":"b"}],
      [{"h":1, "t":"b"}, {"h":1, "t":"b"},{"h":1, "t":"b"},{"h":1, "t":"b"},{"h":1, "t":"b"}, {"h":1, "t":"b"},{"h":1, "t":"b"},{"h":1, "t":"b"},{"h":1, "t":"b"}],
      [{"h":2, "t":"b"}, {"h":2, "t":"b"},{"h":2, "t":"b"},{"h":2, "t":"b"},{"h":2, "t":"b"}, {"h":2, "t":"b"},{"h":2, "t":"b"},{"h":2, "t":"b"},{"h":2, "t":"b"}],
      [{"h":1, "t":"b"}, {"h":1, "t":"b"},{"h":1, "t":"b"},{"h":1, "t":"b"},{"h":1, "t":"b"}, {"h":1, "t":"b"},{"h":1, "t":"b"},{"h":1, "t":"b"},{"h":1, "t":"b"}],
      [{"h":1, "t":"b"}, {"h":1, "t":"b"},{"h":1, "t":"b"},{"h":1, "t":"b"},{"h":1, "t":"l"}, {"h":1, "t":"b"},{"h":1, "t":"b"},{"h":1, "t":"b"},{"h":1, "t":"b"}],
      [{"h":1, "t":"b"}, {"h":1, "t":"b"},{"h":1, "t":"b"},{"h":1, "t":"b"},{"h":1, "t":"b"}, {"h":1, "t":"b"},{"h":1, "t":"b"},{"h":1, "t":"b"},{"h":1, "t":"b"}],
      [{"h":1, "t":"b"}, {"h":1, "t":"b"},{"h":1, "t":"b"},{"h":1, "t":"b"},{"h":1, "t":"b"}, {"h":1, "t":"b"},{"h":1, "t":"b"},{"h":1, "t":"b"},{"h":1, "t":"b"}],
      [{"h":1, "t":"b"}, {"h":1, "t":"b"},{"h":1, "t":"b"},{"h":1, "t":"b"},{"h":1, "t":"b"}, {"h":1, "t":"b"},{"h":1, "t":"b"},{"h":1, "t":"b"},{"h":1, "t":"b"}]
    ],
    "medals": {
      "gold": 4,
      "silver": 5,
      "bronze": 6
    }
  }
]